########
#...#..#
#...#..#
#.###.##
#.###..#
#.####.#
#......#
########
